0 B 5 0 4 0
4 4 4 9 3 4
5 5 1 3 1 9
7 6 4 3 7 2
6 5 9 2 1 3
0 8 4 4 x 0